====================
S..................E
====================
=============s====a=
====================
====c===============
====================
============fg=======
====================
====================
====================
====================
=====3213412========
====================
====================
====================
=====heynowbrowncow=
====================
====================
====================