================================
================================
================================
=========.======================
=========.======================
=========.======================
=S................E=============
================================
================================
================================
================================
================================
================================