====================
====================
====================
====================
====================
====================
====================
====================
==S...............==
============.=======
============.=======
============.=======
============.=======
============E=======
====================
====================
====================
====================
====================
====================