====================
====================
====================
====================
====================
====================
=========.==========
=========.==========
=========.==========
=S................E=
====================
====================
====================
====================
====================
====================
====================
====================
====================
====================
