======.......=======
====.=======.....===
====.........=======
====.=========.E====
==..........==.=.===
==.===.====.==.=.===
==.==....==.==.=...=
==.========.==.===.=
==.=...====.==...=.=
==.=.=.====.====.=.=
==.=.=......====.=.=
==.=.===========.=.=
==.=.===.........=.=
==S=.===.=======.=.=
====.====........=.=
====.====.===.====.=
====.====.===.==...=
====......===.====.=
=============.====.=
=============.......
