====================
====================
====================
====================
====================
====================
====================
====================
====================
====================
===S=E...........===
===.============.===
===.============.===
===.============.===
===.============.===
===.============.===
===.============.===
===..............===
====================
====================